1111112222222222222222222222222222222222222211111
1111110000000000000000000000000000000000000011111
1111110000000000000000000000000000000000000011111
1111110000000000000000000000000000000000000011111
1111110000000000000000000000000000000000000011111
1111110000000002200000000000000000000022200011111
1111110000000000000000000000000000000000000011111
1111110000000000000000000000000000000000000011111
1111110000000222200000000000000000022222200011111
1111110000000000000000000000000000000000000011111
1111110000000000002222200000022222000000000011111
1111110222200000000000000000000000000000000011111
1111110000000003000000000000000000000000000011111
1111110000000222220000000000000000002222220011111
1111110000000000000000002222220000000000000011111
1111110000000000000000000000000000000000000011111
1111110000000000000000000000000000000000000011111
1111112222222222222222222222222222222222222211111
1111111111111111111111111111111111111111111111111
1111111111111111111111111111111111111111111111111
