11111122222222222222553335522222222222222222111111
11111122222222222222555555522222222222222222111111
11111100000000000000000000000000000000000000111111
11111100000000000000000000000000000000000000111111
11111100000000000000000000000000000000000000111111
11111100000000000000000000000000000000000000111111
11111100000000000000000000000000000000000000111111
11111100000000000000000000000000000000000000111111
11111111111111111111111111111111111111111111111111
11111111111111111111111111111111111111111111111111